LevelSize: 8 7

Texture-Level-B1: resources/textur.png
Level-B1:
000 000 000 000 000 000 000 000 
000 000 000 000 000 000 000 000 
000 000 000 000 000 000 000 000 
000 103 000 000 000 000 000 000 
000 000 000 000 000 000 000 000 
000 000 000 000 000 000 000 000 
000 000 000 000 000 000 000 000 

Texture-Level-B2: resources/textur.png
Level-B2:
000 000 000 000 000 000 000 000 
000 000 000 000 000 000 000 000 
000 000 000 000 000 000 000 000 
000 000 000 103 000 000 000 000 
000 000 000 000 000 000 000 000 
000 000 000 000 000 000 000 000 
000 000 000 000 000 000 000 000 

Texture-Level-Zero: resources/textur.png
Level-Zero:
100 103 101 101 101 101 103 101 
101 101 301 000 000 501 103 301 
301 000 000 000 000 000 000 000 
000 000 000 000 000 000 000 000 
000 000 100 000 421 111 221 000 
000 000 420 110 120 110 120 210 
103 103 121 111 121 111 121 111 

Texture-Level-F1: resources/textur.png
Level-F1:
000 000 000 000 000 000 000 000 
000 000 000 000 000 000 000 000 
000 000 000 000 000 000 000 000 
000 000 000 000 000 103 000 000 
000 000 000 000 000 000 000 000 
000 000 000 000 000 000 000 000 
000 000 000 000 000 000 000 000 

Texture-Level-F2: resources/textur.png
Level-F2:
000 000 000 000 000 000 000 000 
000 000 000 000 000 000 000 000 
000 000 000 000 000 000 000 000 
000 000 000 000 000 000 000 103 
000 000 000 000 000 000 000 000 
000 000 000 000 000 000 000 000 
000 000 000 000 000 000 000 000 

